Root Chalice - Всеосяжна Чаша
Isz - Ізз
Sinister - Зловісна
Blood Echoes - Кроваві спогади
Loran - Лоран
Pthumeru - Птумеру


Locations:
Hintertomb - Усамітнена Гробниця


Armory:

Cleaver Saw - Клинкова пила
Blunderbuss - Мушкетон
Hunter’s Axe - Мисливська сокира
Pistol - Пістоль
Kirkhammer (教会の石槌 Church Mallet) - Церковний молот
Warped Twinblades - Викривлені клинки
Blade of Mercy - Меч милосердя


NPCs:
Rom, the Vacuous Spider - Ром, Бездумний Павук
Mergo's Wet Nurse - Годувальниця Мерго
Gehrman, the First Hunter - Герман, Перший Мисливець
Father Gascoigne - Отець Гаскойн
Yharnam, Pthumerian Queen - Ярнам, Птумерійська Королева
Irreverent Izzy ( 背教者イジー) - Відступник Іззі

Blackplume Hunter - Чорноперий мисливець
Church Hunter - Церковний мисливець
Axe Hunter - Мисливець з сокирою
Saw Hunter - Мисливець з пилою


Words:
summon - закликати


Covenants:
Tomb Prospector - Розкрадач Гробниць
Hunter of Hunters (狩人狩り) - Винищувач Мисливців
The Executioners (処刑隊 Execution Squad) - Каральний Загін
The Vileblood (穢れた血族) - Нечистокровні

Rune:
Radiance - Сяйво
